1111111111
1000100001
1010100001
1010100001
1010100001
1010100001
1010101001
1010101001
1010001001
1R11111111
